{
  "tiles": [
    1, 1, 1, 1, 1, 1, 1, 1, 1, 1, 1, 1, 1, 1, 1, 1, 1, 1, 1, 1,
    1, 1, 2, 1, 1, 1, 1, 1, 4, 4, 4, 1, 1, 1, 1, 1, 1, 1, 1, 1,
    1, 2, 2, 2, 2, 1, 1, 4, 4, 4, 4, 4, 1, 1, 1, 1, 1, 1, 1, 1,
    1, 2, 2, 2, 2, 1, 1, 4, 4, 4, 4, 4, 1, 1, 1, 1, 2, 2, 4, 2,
    1, 1, 2, 2, 1, 1, 1, 1, 4, 4, 4, 1, 1, 1, 1, 4, 2, 1, 1, 1,
    1, 1, 1, 1, 1, 1, 1, 1, 1, 1, 1, 1, 2, 2, 2, 4, 1, 1, 1, 1,
    1, 1, 1, 1, 1, 1, 1, 1, 1, 1, 1, 2, 2, 1, 1, 1, 1, 1, 1, 1,
    2, 2, 2, 2, 4, 2, 2, 2, 4, 4, 2, 2, 1, 1, 1, 1, 1, 1, 1, 1,
    1, 1, 1, 1, 1, 1, 1, 1, 1, 1, 1, 1, 1, 1, 1, 9, 9, 1, 1, 1,
    1, 1, 1, 4, 4, 1, 1, 1, 1, 1, 1, 1, 1, 9, 9, 9, 9, 1, 1, 1,
    1, 4, 4, 4, 4, 1, 1, 1, 1, 1, 1, 1, 9, 9, 9, 9, 9, 1, 1, 1,
    1, 1, 4, 4, 4, 4, 1, 1, 1, 1, 1, 1, 9, 9, 9, 9, 1, 1, 1, 1,
    1, 4, 4, 4, 4, 4, 1, 1, 1, 1, 1, 1, 1, 9, 9, 9, 1, 1, 1, 1
  ],
  "tile_width": 256,
  "tile_height": 256,
  "width": 20,
  "height": 13,
  "tileset_path": "./resources/battle-location-top-down-game-tileset-pack/PNG/Tiles/spritesheet.png"
}