{
  "tiles": [
    6, 6, 6, 6, 6, 6, 6, 6, 6, 6, 6, 6, 6, 6, 6, 6, 6, 6, 2, 2,
    6, 2, 5, 6, 2, 2, 6, 6, 6, 6, 6, 6, 6, 6, 6, 6, 6, 2, 2, 2,
    6, 2, 6, 6, 5, 5, 6, 6, 6, 6, 6, 6, 6, 6, 6, 6, 2, 2, 2, 8,
    6, 2, 2, 2, 6, 6, 6, 6, 6, 6, 6, 6, 6, 6, 6, 2, 2, 2, 8, 8,
    6, 6, 6, 6, 5, 5, 6, 6, 6, 6, 6, 6, 6, 6, 2, 2, 2, 8, 8, 8,
    6, 6, 6, 2, 5, 2, 6, 6, 6, 6, 6, 6, 6, 2, 2, 2, 8, 8, 8, 8,
    6, 6, 6, 6, 2, 6, 6, 6, 6, 6, 6, 6, 6, 2, 2, 8, 8, 8, 8, 8,
    6, 6, 6, 6, 6, 5, 2, 6, 2, 6, 5, 8, 2, 2, 2, 8, 8, 8, 8, 8,
    9, 9, 6, 6, 6, 6, 6, 6, 6, 6, 6, 6, 6, 2, 2, 8, 8, 8, 8, 8,
    9, 9, 9, 9, 6, 6, 6, 6, 6, 6, 6, 6, 2, 2, 2, 8, 8, 8, 6, 6,
    9, 9, 9, 9, 9, 6, 6, 6, 6, 6, 6, 2, 2, 2, 8, 8, 8, 6, 6, 2,
    9, 9, 9, 9, 9, 6, 6, 6, 6, 6, 2, 2, 2, 6, 8, 8, 8, 6, 2, 2,
    9, 9, 9, 9, 6, 6, 6, 6, 6, 6, 2, 2, 8, 8, 8, 8, 6, 2, 2, 2
  ],
  "tile_width": 256,
  "tile_height": 256,
  "width": 20,
  "height": 13,
  "tileset_path": "./resources/battle-location-top-down-game-tileset-pack/PNG/spritesheet.png"
}