{
  "tiles": [
    0, 0, 0, 0, 0, 1, 1, 4, 4, 4, 4, 4, 4, 4, 4, 9, 4, 4, 9, 4,
    0, 0, 0, 0, 0, 1, 1, 9, 4, 9, 4, 4, 9, 4, 4, 4, 4, 4, 4, 4,
    0, 0, 0, 0, 0, 1, 1, 4, 4, 4, 4, 4, 4, 4, 4, 4, 9, 4, 4, 4,
    0, 0, 0, 0, 0, 1, 1, 4, 9, 9, 4, 9, 4, 9, 4, 4, 1, 1, 1, 1,
    0, 0, 0, 0, 0, 1, 1, 4, 4, 4, 4, 4, 4, 4, 4, 1, 2, 2, 2, 2,
    1, 1, 0, 1, 1, 1, 1, 4, 9, 4, 4, 4, 4, 4, 1, 2, 2, 8, 8, 8,
    8, 8, 2, 6, 6, 6, 1, 9, 4, 4, 9, 4, 4, 1, 2, 2, 8, 8, 8, 8,
    8, 8, 2, 6, 6, 6, 1, 1, 1, 1, 1, 1, 1, 2, 2, 8, 8, 8, 8, 8,
    8, 8, 2, 2, 2, 2, 2, 2, 2, 2, 2, 2, 2, 2, 8, 8, 8, 8, 8, 8,
    8, 8, 8, 8, 8, 8, 8, 8, 8, 8, 8, 8, 8, 8, 8, 8, 8, 8, 8, 8,
    8, 8, 8, 8, 8, 8, 8, 8, 8, 8, 8, 8, 8, 8, 8, 8, 8, 8, 8, 8,
    8, 8, 8, 8, 8, 8, 8, 8, 8, 8, 8, 8, 8, 8, 8, 8, 8, 8, 8, 8,
    8, 8, 8, 8, 8, 8, 8, 8, 8, 8, 8, 8, 8, 8, 8, 8, 8, 8, 8, 8
  ],
  "tile_width": 256,
  "tile_height": 256,
  "width": 20,
  "height": 13,
  "tileset_path": "./resources/battle-location-top-down-game-tileset-pack/PNG/spritesheet.png"
}